........BBBBBBBBBBBBB.
........B...........B.
........B...........B.
.BBBBBBBB........222B.
d@......1........29.B.
d.......1........29.B.
.BBBBBBBB........222B.
........B...........B.
........B...........B.
........BBBBBBBBBBBBB.
