.......DD.........
.BBBBBB..BBBBBBBB.
.B..............B.
D@..............B.
D................d
.B...............d
.B..............B.
.B..............B.
.BBBBBBB..BBBBBBB.
........DD........
