.BBBB1BBBBBBBBBBBBBBB.
.B..................B.
.B..................2.
.B..................B.
D@...................d
D....................d
.B..................B.
.B..................B.
.B..................B.
.BBBBBBBBBBBBBB3BBBBB.
